##########
#S###    #
#   # ####
### # #D##
#   # # ##
#D# # # ##
###     ##
### ### ##
###     ##
##########
;
##########
#   #   D#
#     ####
###   # ##
#U#   # ##
# #    D##
##########
#       ##
#D# # # ##
##########
;
##########
#        #
# ########
# #U     #
# #      #
# ####   #
#    #####
#### ##U##
# D#    ##
##########
;
##########
#        #
# ###### #
# #    # #
# # ## # #
# #  #   #
# ## # # #
# ##   # #
#  #####G#
##########
;